1111111111111111111111111111111111
1E0000000000000C00000C00000D000001
101001010010000L101001000000010101
101001001010101000100100000001L101
1P0000000C00C0000000000000U00000C1
1111111111111111111111111111111111
