111111111111111
1000000000000L1
100000000000001
1000P000C00E001
100000000000001
100000000000001
111111111111111
